┏━━━━━━━━━━━━━━━━━━━━━━━━━━━━━━━━━━━━━━━━━━━━━━━━━━━━━━━━━━━━━━━━━━━━━━━━━━━━━━━━━━━━━━━━━━━━━━━━━━━━━━━━━━━━━━━━━━━━━━━━━━━━━━━━━━━━━━━━━━━━━━━━━━━━━━━━━━━━━━━━━━━━━━━━━━━━━━━━━━━━━━━━━━━━━━━━━━━━━━━━━━━━━━━━━━━━━━━━━━━━━━━━━━━━━━━━━━━━━━━━━━━━━━━━━━━━━━━━━━━━━━━━━━━━━━━━━━━━━━━━━━━━━━━━━━━━━━━━━━━━━━━━━━━━┓ 
┃                                                                                                                                                                                                                                                                                                                    ┃ 
┃                                                                                                                                                                                                                                                                                                                    ┃ 
┃                                                                                                                                                                                                                                                                                                                    ┃ 
┃                                                                                                                                                                                                                                                                                                                    ┃ 
┃                                                                                                                                                                                                                                                                                                                    ┃ 
┃                                                                                                                                                                                                                                                                                                                    ┃ 
┃                                                                                                                                                                                                                                                                                                                    ┃ 
┃                                                                                                                                                                                                                                                                                                                    ┃ 
┃                                                                                                                                                                                                                                                                                                                    ┃ 
┃                                                                                                                                                                                                                                                                                                                    ┃ 
┃                                                               ╱╲╱╲╱╲╱╲                                                                                                                                                                                                                                                      ┃ 
┃                                                ┏━━━━━━━━━━━━━━━━━━━━━━━━━━━━━━━━━━━                                                                                                                                                                                                                                ┃ 
┃                                                ┃                                                                                                                                                                                                                                                                   ┃ 
┃                                          ┏━━━━━┛                                                                                                                                                                                                                                                                   ┃ 
┃                                          ┃                                                                                                                                                                                                                                                                         ┃ 
┃                           ┏━━━━━━━━━━━━━━┛                                                                                                                                                                                                                                                                         ┃ 
┗━━━━━━━━━━━━━━━━━━━━━━━━━━━┻━━━━━━━━━━━━━━━━━━━━━━━━━━━━━━━━━━━━━━━━━━━━━━━━━━━━━━━━━━━━━━━━━━━━━━━━━━━━━━━━━━━━━━━━━━━━━━━━━━━━━━━━━━━━━━━━━━━━━━━━━━━━━━━━━━━━━━━━━━━━━━━━━━━━━━━━━━━━━━━━━━━━━━━━━━━━━━━━━━━━━━━━━━━━━━━━━━━━━━━━━━━━━━━━━━━━━━━━━━━━━━━━━━━━━━━━━━━━━━━━━━━━━━━━━━━━━━━━━━━━━━━━━━━━━━━━━━━━━━━━┛ 
