┏━━━━━━━━━━━━━━━━━━━━━━━━━━━━━━━━━━━━━━━━━━━━━━━━━━━━━━━━━━━━━━━━━━━━━━━━━━━━━━━━━━━━━━━━━━━━━━━━━━━━━━━━━━━━━━┓
┃                                                                                                              ┃
┃                                                                                                              ┃
┃                                                                                                              ┃
┃                                                                                                              ┃
┃                                       ┃                                                                      ┃
┣━━━━━━━━━━━━━━━┳━━━━━━━━━              ┃                                                                      ┃
┃               ┃                       ┃                                                                      ┃
┃               ┗━━━━━━━━━━━━━━         ┃                                                                      ┃
┃                                    ━━━┫ ━━━                                                                  ┃
┃                                       ┃                                                                      ┃
┃                                       ┃                                                                      ┃
┃                           ━━━━━━━━━━━━┫━━━━━━━━━━━━                                                          ┃
┃                                       ┃                                                                      ┃
┃                                       ┃                                                                      ┃
┃              ━━━━━      ━━━━━━━━━━━━━━┫━━━━━━━━━━━━━━                                                        ┃
┃                                       ┃                                                                      ┃
┗━━━━━━━━━━━━━━━━━━━━━━━━━━━━━━━━━━━━━━━┻━━━━━━━━━━━━━━━━━━━━━━━━━━━━━━━━━━━━━━━━━━━━━━━━━━━━━━━━━━━━━━━━━━━━━━┛
