┏━━━━━━━━━━━━━━━━━━━━━━━━━━━━━━━━━━━━━━━━━━━━━━━━━━━━━━━━━━━━━━━━━━━━━━━━━━━━━━━━━━━━━━━━━━━━━━━━━━━━━━━━━━━━━━┓
┃                                                                                                              ┃
┃                                                                                                              ┃
┃                                                                                                              ┃
┃                                                                                                              ┃
┃                                       ┃                                                                      ┃
┣━━━━━━━━━━━━━━━━━━━━━━━━               ┃                                                                      ┃
┃                                       ┃                                                                      ┃
┃                                       ┃                                                                      ┃
┃                              ━━━━━━━━━┫                                                                      ┃
┃                                       ┃                                                                      ┃
┃                                       ┃                                                                      ┃
┃                         ━━━━━━━━━━━━━━┫                                                                      ┃
┃                                       ┃                                                                      ┃
┃                                       ┃                                                                      ┃
┃                    ━━━━━━━━━━━━━━━━━━━┫                                                                      ┃
┃                                       ┃                                                                      ┃
┗━━━━━━━━━━━━━━━━━━━━━━━━━━━━━━━━━━━━━━━┻━━━━━━━━━━━━━━━━━━━━━━━━━━━━━━━━━━━━━━━━━━━━━━━━━━━━━━━━━━━━━━━━━━━━━━┛