┏━━━━━━━━━━━━━━━━━━━━━━━━━━━━━━━━━━━━━━━━━━━━━━━━━━━━━━━━━━━━━━━━━━━━━━━━━━━━━━━━━━━━━━━━━━━━━━━━━━━━━━━━━━━━━━━━━━━━━━━━━━━━━━━━━━━━━━━━━━━━━━━━━━━━━━━━━━━━━━━━━━━━━━━━━━━━━━━━━━━━━━━━━━━━━━━━━━━━━━━━━━━━━━━━━━━━━━━━━━━━━━━━━━━━━━━━━━━━━━━━━━━━━━━━━━━━━━━━━━━━━━━━━━━━━━━━━━━━━━━━━━━━━━━━━━━━━━━━━━━━━━━━━━━━┓ 
┃                                                                                                                                                                                                                                                                                                                    ┃ 
┃                                                                                                                                                                                                                                                                                                                    ┃ 
┃                                                                                                                                                                                                                                                                                                                    ┃ 
┃                                                                                                                                                                                                                                                                                                                    ┃ 
┃                                                                                                                                                                                                                                                                                                                    ┃ 
┃                                                                                                                                                                                                                                                                                                                    ┃ 
┃                                                                                                                                                                                                       ╱╲  ┏━━━━━━━━━┓   ╱╲                                                                                         ┃ 
┃                                                                                                                                                                                                   ┏━━━━━━━┛         ┗━━━━━━━┓                                                                                      ┃ 
┃                                                                                                                                                                                   ┏━┓             ┗━━━━━━━━━━━━━━━━━━━━━━━━━┛                                                                                      ┃ 
┃                                                                                                                                                                     ┏━┓           ┗━┛                                                                                                                              ┃ 
┃                                                               ╱╲╱╲╱╲╱╲                                                                                 ┏━┓          ┗━┛                                                                                                                                            ┃ 
┃                                                ┏━━━━━━━━━━━━━━━━━━━━━━━━━━━━━━━━━━━┓               ━━━━━━━━━━━━━━                                      ┗━┛                                                                                                                                                         ┃ 
┃                                                ┃                                   ┗┓              ╲╱          ╲╱                         ┏━┓                                                                                                                                                                      ┃ 
┃                                          ┏━━━━━┛                                    ┗┓                                      ┏━┓           ┗━┛                                                                                                                                                                      ┃ 
┃                                          ┃                                           ┗┓                                     ┗━┛                                                                                                                                                                                    ┃ 
┃                           ┏━━━━━━━━━━━━━━┛                                            ┗┓                 ╱╲                            ╱╲╱╲╱╲╱╲╱╲╱╲╱╲╱╲╱╲╱╲╱╲╱╲╱╲╱╲╱╲╱╲╱╲╱╲╱╲╱╲╱╲╱╲╱╲╱╲╱╲╱╲╱╲╱╲╱╲╱╲╱╲╱╲╱╲╱╲╱╲╱╲╱╲╱╲╱╲╱╲╱╲╱╲╱╲                                                                                      ┃ 
┗━━━━━━━━━━━━━━━━━━━━━━━━━━━┻━━━━━━━━━━━━━━━━━━━━━━━━━━━━━━━━━━━━━━━━━━━━━━━━━━━━━━━━━━━━┻━━━━━━━━━━━━━━━━━━━━━━━━━━━━━━━━━━━━━━━━━━━━━━━━━━━━━━━━━━━━━━━━━━━━━━━━━━━━━━━━━━━━━━━━━━━━━━━━━━━━━━━━━━━━━━━━━━━━━━━━━━━━━━━━━━━━━━━━━━━━━━━━━━━━━━━━━━━━━━━━━━━━━━━━━━━━━━━━━━━━━━━━━━━━━━━━━━━━━━━━━━━━━━━━━━━━━━━━━━━┛ 
